
X                                                                 X
X           XXXX                                                  X
XXXX                                                              X
X       XXXXX   XXXXX                                             X
X              XXXXXXXXX                                          X
XXXXXXXXX    XXXXXXXXXXXXXXXXXXXXXXXXXXXXXXXXXXXX                 X
X                                                                 X
X  XXXXXXXXXXXXXX    XXXXXXX                                      X
X                                                                 X
X         XXXXXXXXXXXXXXXXXXXXXXXXXXXXXXXXXXXXXXXX                X
X                                                                 X
XXXXXXXXXXXXXXXXXXXXX                                             X
X                                                                 X
X         XXXXXXXXXXXXXXXXXXXXXXXXXXXXXXXXX                       X
X                                                                 X
XXXXXXXXXXXXXXXXXXXXXXXXXXXXXXXXXXXXXXXXXXXXXXXXXXXXXXXXXXXXXXXXXXX